###               #########
# ### ###########       ###
#   #       # ##### #######
# ##### ### #   #   #     #
#     #   # ### ### ##### #
##### ### #   #   #   #   #
#       # ##### ##### ### #
# ##### # #   #   # #   # #
# #   # # # ### ### # ### #
# # # # #   #   #   #   # #
# # ### ### # ### ##### # #
# #            B #     #  #
# ####  # ##### ######### #
#       # #           #   #
####### # ########### # ###
#       #           #     #
### ######################
A          
